,createdAt,COUNT,organization_id,Organisations sans compte pro actif,Pourcentage
0,2020-11,1034,2520,1486,41.03
1,2020-12,27,48,21,56.25
2,2021-01,23,28,5,82.14
3,2021-02,70,128,58,54.69
4,2021-03,40,80,40,50.0
5,2021-04,53,56,3,94.64
6,2021-05,35,71,36,49.3
7,2021-06,125,386,261,32.38
8,2021-07,44,110,66,40.0
9,2021-08,30,83,53,36.14
10,2021-09,37,65,28,56.92
11,2021-10,80,119,39,67.23
12,2021-11,53,366,313,14.48
13,2021-12,66,154,88,42.86
